
Number of sections : 27 
Size of largest section : 2463


#####################################################################################################
#X           XXXXX XXXXXXX   XXX XXX                                                                #
#X# # # # # #X# #X#X# # #X# #X#X#X#X# # # # # # # # # # # # # # # # # # # # # # # # # # # # # # # # #
#XXXXX XXXXXXX XXX X     XXX X X X X                                                                #
# # #X#X# # # #X# #X# # # #X#X#X#X#X# # # # # # # # # # # # # # # # # # # # # # # # # # # # # # # # #
#    X XXX     X XXX       XXX XXX X XXX                                                            #
# # #X# #X# # #X#X# # # # # # # # #X#X#X# # # # # # # # # # # # # # # # # # # # # # # # # # # # # # #
#    X   X     XXX                 XXX X                                                            #
# # #X# #X# # # # # # # # # # # # # # #X# # # # # # # # # # # # # # # # # # # # # # # # # # # # # # #
#XXXXX XXX                             X                                                            #
#X# # #X# # # # # # # # # # # # # # # #X# # # # # # # # # # # # # # # # # # # # # # # # # # # # # # #
#X XXXXX                               X                                                            #
#X#X# # # # # # # # # # # # # # # # # #X# # # # # # # # # # # # # # # # # # # # # # # # # # # # # # #
#X XXX                                 XXXXX                                                        #
#X# #X# # # # # # # # # # # # # # # # # # #X# # # # # # # # # # # # # # # # # # # # # # # # # # # # #
#X XXX                                     X XXXXX   XXX                                            #
#X#X# # # # # # # # # # # # # # # # # # # #X#X# #X# #X#X# # # # # # # # # # # # # # # # # # # # # # #
#X XXXXX                                   XXX   XXXXX X                                            #
#X# # #X# # # # # # # # # # # # # # # # # # # # # # # #X# # # # # # # # # # # # # # # # # # # # # # #
#XXXXXXX                                             XXX                                            #
# # # # # # # # # # # # # # # # # # # # # # # # # # #X# # # # # # # # # # # # # # # # # # # # # # # #
#                                                    X                                              #
# # # # # # # # # # # # # # # # # # # # # # # # # # #X# # # # # # # # # # # # # # # # # # # # # # # #
#                                                    X                                              #
# # # # # # # # # # # # # # # # # # # # # # # # # # #X# # # # # # # # # # # # # # # # # # # # # # # #
#                                                    X                                              #
# # # # # # # # # # # # # # # # # # # # # # # # # # #X# # # # # # # # # # # # # # # # # # # # # # # #
#                                                    X                                              #
# # # # # # # # # # # # # # # # # # # # # # # # # # #X# # # # # # # # # # # # # # # # # # # # # # # #
#                                                    XXXXX                                          #
# # # # # # # # # # # # # # # # # # # # # # # # # # # # #X# # # # # # # # # # # # # # # # # # # # # #
#                                                        X                                          #
# # # # # # # # # # # # # # # # # # # # # # # # # # # # #X# # # # # # # # # # # # # # # # # # # # # #
#                                                        X                                          #
# # # # # # # # # # # # # # # # # # # # # # # # # # # # #X# # # # # # # # # # # # # # # # # # # # # #
#                                                        X                                          #
# # # # # # # # # # # # # # # # # # # # # # # # # # # # #X# # # # # # # # # # # # # # # # # # # # # #
#                                                        X                                          #
# # # # # # # # # # # # # # # # # # # # # # # # # # # # #X# # # # # # # # # # # # # # # # # # # # # #
#                                                        X                                          #
# # # # # # # # # # # # # # # # # # # # # # # # # # # # #X# # # # # # # # # # # # # # # # # # # # # #
#                                                XXX XXXXX                                          #
# # # # # # # # # # # # # # # # # # # # # # # # #X#X#X# # # # # # # # # # # # # # # # # # # # # # # #
#                                          XXX XXX XXX                                              #
# # # # # # # # # # # # # # # # # # # # # #X#X#X# # # # # # # # # # # # # # # # # # # # # # # # # # #
#                                        XXX XXX                                                    #
# # # # # # # # # # # # # # # # # # # # #X# # # # # # # # # # # # # # # # # # # # # # # # # # # # # #
#                                    XXXXX       XXX   XXXXXXX                                      #
# # # # # # # # # # # # # # # # # # #X# # # # # #X#X# #X# # #X# # # # # # # # # # # # # # # # # # # #
#                                    XXX XXX XXXXX X XXX     X                                      #
# # # # # # # # # # # # # # # # # # # #X#X#X#X# # #X#X# # # #X# # # # # # # # # # # # # # # # # # # #
#                                      XXX XXX     X X     XXX                                      #
# # # # # # # # # # # # # # # # # # # # # # # # # #X#X# # #X# # # # # # # # # # # # # # # # # # # # #
#                                                  XXX     XXXXXXX                                  #
# # # # # # # # # # # # # # # # # # # # # # # # # # # # # # # # #X# # # # # # # # # # # # # # # # # #
#                                                          XXXXXXX                                  #
# # # # # # # # # # # # # # # # # # ### # # # # # # # # # #X# # # # # # # # # # # # # # # # # # # # #
#                                   # #                    X                                        #
# # # # # # # # # # # # # # # # # # ### # # # # # # # # # #X# # # # # # # # # # # # # # # # # # # # #
#                                                          X                                        #
# # # # # # # # # # # # # # # # # # # # # # # # # # # # # #X# # # # # # # # # # # # # # # # # # # # #
#                                                          X                                        #
# # # # # # # ##### # # # # # # # # # # # # # # # # # # # #X# # # # # # # # # # # # # # # # # # # # #
#             # # #                              XXXXXXXXX X                                        #
# # # # # # # ##### # # # # # # # # # # # # # # #X# # # #X#X# # # # # # # # # # # # # # # # # # # # #
#             # # #                              X     XXX X                                        #
# # # # # # # ##### # # # # # # # # # # # # # # #X# # #X# #X# # # # # # # # # # # # # # # # # # # # #
#                                              XXX XXXXX XXX                 XXXXXXX                #
# # # # # # # # # # # # # # # # # # # # # # # #X# #X# # #X# # # # # # # # # #X# # #X# # # # # # # # #
#                                              XXX X     X                   XXX   X       XXXXX    #
# # # # # # # # # # # # ### # # # # # # ### # # #X#X# # #X# # # # # # # # # # #X# #X# # # #X# #X# # #
#                       # #             # #  XXXXX X     X                   XXX XXX       X   X    #
# # # # # # # # # # # # ############# # ### #X# # #X# # #X# # # # # # # # # #X# #X# # # # #X# #X# # #
#                         # # # # # #        X     XXXXX X                 XXX   X     XXXXX XXX    #
# # # # # # # # # # # # # ############# # # #X# # # # #X#X# # # # # # # # #X# # #X# # #X# # #X# # # #
#                         # #       # #      XXX       X X               XXX XXX XXXXXXX     XXXXX  #
# # # # # # # # # # # # # ### # # # ### # # # #X# # # #X#X# # # # # # # #X# #X#X# # # # # # # # #X# #
#                         # #       # #        X     XXX X           XXXXX   X XXXXXXXXXXXXX     X  #
# # # # # # # # # # # # # ### # # # ### # # # #X# # #X# #X# # # # # #X# # # #X# # # # # # #X# # #X# #
#                         # #       # #        XXX XXX   X           X       XXXXXXX       XXXXXXX  #
# # # # # # # # # # # # # ############# # # # # #X#X# # #X# # # # # #X# # # # # # #X# # # # # # # # #
#                         # # # # # #        XXXXX XXX   X           X             X       XXX XXX  #
# # # # # # # # # # # # ############# # ### #X# # # #X# #X# # # # # #X# # # # # # #X# # # #X#X#X#X# #
#                       # #             # #  X       X   X XXX   XXX XXX           X     XXX XXX XXX#
# # # # # # # # # # # # ### # # # # # # ### #X# # # #X# #X#X#X# #X#X# #X# # # # # #X# # #X# # # # #X#
#                                            X       XXXXX X XXXXX X   X           X XXXXX XXXXXXXXX#
# # # # # # # # # # # # # # # # # # # # # # #X# # # # # # #X# # # #X# #X# # # # # #X#X# # #X# # # # #
#                                            XXX XXXXXXXXXXX       XXXXX           XXX     XXX      #
# # # # # # # # # # # # # # # # # # # # # # # #X#X# # # # # # # # # # # # # # # # # # # # # #X# # # #
#                                              X X   XXX                                     XXX    #
# # # # # # # # # # # # # # # # # # # # # # # #X#X# #X#X# # # # # # # # # # # # # # # # # # # #X# # #
#                                      XXXXXXXXX XXXXX X                                       XXXXX#
# # # # # # # # # # # # # # # # # # # #X# # # # # # # #X# # # # # # # # # # # # # # # # # # # # # #X#
#                                      XXXXXXX     XXXXX                                           X#
# # # # # # # # # # # # # # # # # # # # # # #X# # #X# # # # # # # # # # # # # # # # # # # # # # # #X#
#                                        XXXXX XXXXX                                         XXXXXXX#
# # # # # # # # # # # # # # # # # # # # #X# # #X# # # # # # # # # # # # # # # # # # # # # # #X# # # #
#                                        XXX   XXX                                           XXX    #
# # # # # # # # # # # # # # # # # # # # # #X# # #X# # # # # # # # # # # # # # # # # # # # # # #X# # #
#                                          XXXXXXX                                             XXXXX#
#####################################################################################################